




1111111111111
1001C000000C1
1000C11111001
1P001100E0001
1111111111111



