




1111111111111111111111111111111111


1E0000000000001C10000C000000000001
1010010100100001101001000000010101
1010010010101010001001000000010101
1P000000C00C0000000000000000000C11
1111111111111111111111111111111111



