




1111111111111
1001C0000C0C1
1000C01111001
1P001100E0001
1111111111111



