


1111111111111111111111111111111111
1E00000000000000000000000000C00001
1000001000010000000000000000000001
1000000000010010000000000000000001
1000P0000000X00000C000000000000011
1111111111111111111111111111111111

