


1111111111111111111111111111111111
1E00000000000000000000000000C00001
1110010100100001101001000000011101
1011010010100010001001000000010101
1000P0000000001000C000000000000011
1111111111111111111111111111111111

