


1111111111111111111111111111111111
1E00000000000000100000000000000001
1010010100100001101001000000010101
1011010010101110001001000000010101
10000P0000000C10000000000000000011
1111111111111111111111111111111111

