


1111111111111111111111111111111111
1E00C0000000000000C000000000000001
1110010100100001101001000000011101
1011C100101000100C100100000001C101
1000P0000000C0100000C0000000000011
1111111111111111111111111111111111

