


1111111111111111111111111111111111
1E00000000000000000000000000000001
1010010100100001101001000000010101
1011010010100010001001000000010101
1000P0000000C010000000000000000011
1111111111111111111111111111111111

